R 1000 000000600
EA ./textures/E.xpm
NO ./textures/N.xpm
SO ./textures/S.xpm
S ./textures/bob512.xpm
F 194, 136, 151
C 232, 159, 115
WE ./textures/W.xpm

1
        1111111111111111111111111
        1000000000110000000000001
        10110000011100000020000011111111
        10010000000000000000000011111111
111111111011002001110000000000001
100000000011000001110111100011111
11112111111111011100000000001
11110111111111011101010000001
11000000110101011100000000001
100020000000000011000000W0001
10000000000000001101000000001
11000001110101011111000000001
11110111  1 11110101110000001
12220221    11111111111111111
10200201
12222221
12220221
12022201
10220201
12222221
12220221
10220201
12222221
12220221
12022201
10220201
12222221
12220221
12022201
10220201
12222221
12220221
10220201
12222221
12220221
12022201
12222221
12222221
12222221
12222221
12222221
12222221
12222221
12222221
12222221
12222221
12222221
12222221
12222221
12222221
12222221
12222221
12222221
12222221
12222221
12222221
12222221
12222221
12222221
12222221
12222221
12222221
12222221
12222221
12222221
12222221
12222221
12222221
12222221
12222221
12222221
12222221
12222221
12222221
12222221
12222221
12222221
12222221
12222221
12222221
12222221
11111111