R 1024 768
WE ./textures/wall_4.xpm
EA ./textures/wall_3.xpm
NO ./textures/wall_1.xpm
S ./textures/sprite_1.xpm
SO ./textures/wall_2.xpm

C 56, 56, 56
F 113, 113, 113

        1111111111111111111111111
        1000000000110000000000001
        1011000001110000002000001
        1001000000000000000000001
111111111011002001110000000000001
100000000011000001110111100011111
11110111111111011100000000001
11110111111111011101010000001
11000000112121211100000000001
10002000000000001100000020001
100S0000000000001101000000001
11000001112121211111000000001111
11110111  1 111101011100000000001
12222221     1111111 111111111111
11111111
